B  |||||||||||||||||||||||||||||||||||||||||||
                  |        |           |     |
|  ||||  ||||||||||  |||||||  ||||  |  |  |  |
|     |                 |  |     |  |     |  |
||||||||||  ||||  ||||  |  |  |||||||  |  |  |
|              |  |              |     |  |  |
||||||||||  |  ||||||||||||||||  |||||||||||||
|           |  |                              
|||||||||||||||||||||||||||||||||||||||||||  X