   |||||||||||||||||||||||||||||||||||||||||||
   |                          |     |  |   C |
|  |||||||  |  |  |  ||||  |  ||||  |  |  ||||
|           |  |  |     |  |     |     |     |
|  |  ||||||||||  |  ||||  |  |||||||  |  |  |
|  |  |     |  |  |     |  |     |        |  |
||||  |  ||||  ||||||||||  ||||  |  ||||||||||
|  |        |     |        |              |  |
|  |  |||||||  |||||||  ||||||||||  ||||  |  |
|     |  |  |           |  |        |        |
||||  |  |  ||||||||||  |  ||||  |||||||||||||
|     |           |           |  |     |     |
|  ||||  |  |||||||  ||||||||||  |  |  ||||  |
|        |  |     |  |     |        |        |
||||  |  ||||  |  ||||  ||||||||||  |||||||  |
|     |  |     |           |        |        |
|  ||||  |  |  |||||||||||||||||||  ||||  ||||
|  |  |     |  |     |  |        |  |     |  |
|  |  |  ||||  |  ||||  ||||  |||||||  |  |  |
|     |   C |                 |        |     X
|||||||||||||||||||||||||||||||||||||||||||   
                                              