B  |||||||||||||||||||||||||||||||||||||||||||
   |     |        |  |           |           |
|  |  ||||||||||  |  |  ||||  ||||  ||||  ||||
|                 |  |     |        |        |
|  ||||  |  |||||||  |  |||||||  ||||  ||||  |
|  |  |  |     |        |        |        |  |
|  |  ||||  ||||  ||||||||||  |||||||  ||||  |
|  |        |  |     |  |           |  |  | F|
|  |||||||  |  |  |  |  |||||||||||||  |  ||||
|  |     |  |     |        |  |  |  |  |  |  |
|  |  |  |  ||||  |  |||||||  |  |  |  |  |  |
|  |  |     |  |  |  |                 |  |  |
|||||||  ||||  ||||  |  ||||  ||||  ||||  |  |
|  |        |        |  |        |           |
|  ||||  ||||  |||||||  |  ||||||||||  ||||  |
|                    |  |  |  |  |  |     |  |
|||||||  |||||||  ||||||||||  |  |  |||||||  |
|        |     |  |  |        |     |        |
|  ||||  ||||  |  |  |  ||||  |  ||||  ||||  |
|    G|     |              |  |           |   
|||||||||||||||||||||||||||||||||||||||||||  E
                                              